1111111111111111
1000000000000001
1000111110000101
1010000010000101
1010111011110101
1010001000010101
1011111000010101
1000000000010101
1001111111110101
1001000000010101
1001001111010101
1001001001010101
1001111001010101
1000000001010101
1111111111010101
1000000000010001
1011111111111101
1010000000000001
1010111111111101
1010N00000000001
1111111111010101
1000000000010001
1011111111111101
1010000000000001
1010111111111101
1010000000000001
1010000000000001
1010000000000001
1010000000000001
1010000000000001
1010000000000001
1010000000000001
1111111111111111
