




NO textures/wall_1.xpm
SO textures/wall_2.xpm

F 199,45,91
EA textures/wall_3.xpm

WE textures/wall_4.



C 41,117,119















111111111111111111111
100000000000000011111111
1000000000000111100000N1
111111111111111111111111

