




NO textures/wall_1.xpm
SO textures/wall_2.xpm

EA textures/wall_3.xpm

WE textures/wall_4.xpm









F 199,45,91

C 41,117,119













111111111111111111111
10000000000000000000001
1000000000000000000N1
111111111111111111101
1111111111111111111

