
NO ./textures/redbrick.xpm
SO ./textures/bluestone.xpm
WE ./textures/wood.xpm
EA ./textures/mossy.xpm

F 255,255,255
C 135,206,235


111111111111
100000000001
101111000101
101000000101
1010N1100101
101000000101
101111000101
100000000001
111111111111