111111111111111111111
10000000000000000000001
1000000000000000000W1
1111111111111111111
1111111111111111111





